kinkkom-kinky
kingkom-for gigantiske aper som invaderer NY
kinkom- støttegruppe for familier til fysikk og mattematikk studenter
klinkkom - folk som liker å drikke fra glassflaske
klingkom - sang
klinkom - gjennopstandelsen av tafsekom
kimkom - verdenherredømme og bollesveis
blingkom - stilige deltagere
finnkom -  for finner i delta som liker å handle brukt
svinkom -  for fyllesvin
minkom - for kleptomane deltagere
	vårkom - kommunistiske deltagere
dinkom - for gavmilde deltagere
vinkom - vinkjellern
income - for oss som liker intekter
finkom - for deltagere som ser bra ut
svinnkom - medkom
pinnkom -for vi som liker pins
ginkom - for deltagere som syntes 40% er blandevann
spinkom - for deltagere som føler de kan mekfys og kvante
grinkom - for vi som har eksamen
grindkom - for deltagere som savner bondelivet
vindkom - for deltagere fra kystområder
vinnkom - komkom
sinkom - for deltagere med dieter, allergier og intoleranser
blindkom -for blinde deltagere
	døvblindkom - for døvblinde deltagere
stinnkom - for indøkere som har byttet til delta 
måneskinnkom - felleskomiteen for deltagere med manglende hår, romanse, astronomi, kulde og hjemmebrenner 
grønnsakskom - dragvoll
3kom - for (sivil)ingenører som har gått delta
kleinkom - delta
meinkom - for antisemitisiske deltagere
reinkom - for deltagere som egentlig er reinsdyr som studerer matte for å lære å telle reinflokken
gainkom - treningskomiten i delta
sinnkom - komite for å i vareta mentalhelse i delta 
kinnkom - for svigermødre i delta
russelkom - komitene som kun inneholder deltagere som ikke er med i noen komiteer
tindkom - underlagt telta for de som vil gå veldig lange toppturer
tinkom - for deltagere som vil finne kjærligheten på nettet
integralkom - for mattenerder i delta
intkom - for alle diskret personer i delta
skinnekom - tog entusiaster i delta


arrkom- for deltagere som har arr
narrkom - for deltagere med humor
narkom - for deltagere med rusmissbruksproblemer

reddkom - for skvetne deltagere